111111111111111111111111111
100001000000000000000000001
100010000001000000000000001
11000000000CCCC000000000001
11C00011110CPC0011000000001
10CE0000000CCC0000000000001
10000C110000001111111110001
1000C0000000000000000000001
100000000001100000000000001
111111111111111111111111111