111111111111111111111111111
1000C1000000000000000000001
1E0010000001000000000000001
110000000001000000000000001
110000111100000011000000001
1P0000000000000000000000001
100000111111111111111110001
1000000000000000000CC000001
1000000000011000000CC000001
111111111111111111111111111