111111111111111111111111111
100001000000000000000000001
100010000001000000000000001
110000000001000000000000001
11C000111100000011000000001
1PCE00000000000000000000001
100000110000001111111110001
1000C0000000000000000000001
100000000001100000000000001
111111111111111111111111111