1111111111111111
1000C00000000001
1E00000000010001
1100000000010001
1100001111000001
1P00000000000001
1111111111111111