1111111111111111111111
1000C00000000000000001
1E00000000010000000001
1100000000010000000001
1100001111000000000001
1P00000000000000000001
1111111111111111111111