111111111111111111111111111
1000C0000000000000000000001
1E0000000001000000000000001
110000000001000000000000001
110000111100000000000000001
1P0000000000000000000000001
100000000000000000000000001
100000000000000000000000001
100000000000000000000000001
111111111111111111111111111