111111111111111111111111111
100001000000000000000000001
1E00100000010C0000000000001
110000000001000000000000001
110000111100000011000000001
1P0000000000000000000000001
1000C0111111111111111110001
100000000000000000000000001
1000000000011000000C0000001
111111111111111111111111111